20
15
5 5 5 5 5 5 5 5 5 5 5 5 5 5 5 5 5 5 5 5
5 5 5 5 5 5 5 5 5 5 5 5 5 5 5 5 5 5 5 5
5 5 5 5 5 5 5 5 5 5 5 5 5 5 5 5 5 5 5 5
5 5 5 5 5 5 5 5 5 5 5 5 5 5 5 5 5 5 5 5
5 5 5 5 5 5 5 5 5 5 5 5 5 5 5 5 5 5 5 5
5 5 5 5 5 5 5 5 5 5 5 5 5 5 5 5 5 5 5 5
5 5 5 5 5 5 5 5 5 5 5 5 5 5 5 5 5 5 5 5
5 5 5 5 5 5 5 5 5 5 5 5 5 5 5 5 5 5 5 5
5 5 5 5 5 5 5 5 5 5 5 5 5 0 1 1 1 1 1 1
5 5 5 5 5 5 5 5 5 5 5 5 5 3 2 2 2 2 2 2
5 5 5 5 5 5 5 5 5 5 5 5 5 3 2 2 2 2 2 2
5 5 5 5 5 5 5 5 5 5 5 5 5 3 2 2 2 2 2 2
5 5 5 5 5 5 5 5 5 5 5 5 5 3 2 2 2 2 2 2
5 5 5 5 5 5 5 5 5 5 5 5 5 3 2 2 2 2 2 2
5 5 5 5 5 5 5 5 5 5 5 5 5 3 2 2 2 2 2 2